##########
#A       #
#  ##### #
#        #
# ###### #
#        #
#  #####E#
##########